###################
#     ####       @#
#      ###        #
#       ##   ######
#    #   #        #
#   ##            #
#  ###          # #
#  ###        ##  #
#  ###    ##      #
###################
